{
    tileset: "frosthaven",
    mapRef: "09b",
    offset: {
        x: -16,
        y: -35
    },
    cells: [
        { x: 0, y: 0 },
        { x: 1, y: 0 },
        { x: 2, y: 0 },
        { x: 3, y: 0 },
        { x: 4, y: 0 },
        { x: 5, y: 0 },
        { x: 0, y: 1 },
        { x: 1, y: 1 },
        { x: 2, y: 1 },
        { x: 3, y: 1 },
        { x: 4, y: 1 },
        { x: 5, y: 1 },
        { x: 6, y: 1 },
        { x: 2, y: 2 },
        { x: 3, y: 2 },
        { x: 2, y: 3 },
        { x: 3, y: 3 },
        { x: 4, y: 3 },
        { x: 2, y: 4 },
        { x: 3, y: 4 },
        { x: 2, y: 5 },
        { x: 3, y: 5 },
        { x: 4, y: 5 },
        { x: 2, y: 6 },
        { x: 3, y: 6 }
    ]
}
