{
    tileset: "frosthaven",
    mapRef: "11b",
    offset: {
        x: 41,
        y: -23
    },
    cells: [
        { x: 2, y: 0 },
        { x: 1, y: 1 },
        { x: 2, y: 1 },
        { x: 3, y: 1 },
        { x: 1, y: 2 },
        { x: 2, y: 2 },
        { x: 3, y: 2 },
        { x: 2, y: 3 },
        { x: 3, y: 3 },
        { x: 4, y: 3 },
        { x: 2, y: 4 },
        { x: 3, y: 4 },
        { x: 4, y: 4 },
        { x: 5, y: 4 },
        { x: 6, y: 4 },
        { x: 7, y: 4 },
        { x: 8, y: 4 },
        { x: 3, y: 5 },
        { x: 4, y: 5 },
        { x: 5, y: 5 },
        { x: 6, y: 5 },
        { x: 7, y: 5 },
        { x: 8, y: 5 },
        { x: 4, y: 6 },
        { x: 5, y: 6 },
        { x: 6, y: 6 },
        { x: 7, y: 6 },
        { x: 8, y: 6 }
    ]
}
