{
    tileset: "frosthaven",
    mapRef: "11c",
    offset: {
        x: -51,
        y: -25
    },
    cells: [
        { x: 5, y: 0 },
        { x: 5, y: 1 },
        { x: 6, y: 1 },
        { x: 7, y: 1 },
        { x: 4, y: 2 },
        { x: 5, y: 2 },
        { x: 6, y: 2 },
        { x: 4, y: 3 },
        { x: 5, y: 3 },
        { x: 6, y: 3 },
        { x: 0, y: 4 },
        { x: 1, y: 4 },
        { x: 2, y: 4 },
        { x: 3, y: 4 },
        { x: 4, y: 4 },
        { x: 5, y: 4 },
        { x: 0, y: 5 },
        { x: 1, y: 5 },
        { x: 2, y: 5 },
        { x: 3, y: 5 },
        { x: 4, y: 5 },
        { x: 5, y: 5 },
        { x: 0, y: 6 },
        { x: 1, y: 6 },
        { x: 2, y: 6 },
        { x: 3, y: 6 }
    ]
}
