{
    tileset: "frosthaven",
    mapRef: "11d",
    offset: {
        x: -36,
        y: -24
    },
    cells: [
        { x: 1, y: 0 },
        { x: 0, y: 1 },
        { x: 1, y: 1 },
        { x: 2, y: 1 },
        { x: 0, y: 2 },
        { x: 1, y: 2 },
        { x: 2, y: 2 },
        { x: 1, y: 3 },
        { x: 2, y: 3 },
        { x: 3, y: 3 },
        { x: 1, y: 4 },
        { x: 2, y: 4 },
        { x: 3, y: 4 },
        { x: 4, y: 4 },
        { x: 5, y: 4 },
        { x: 6, y: 4 },
        { x: 7, y: 4 },
        { x: 2, y: 5 },
        { x: 3, y: 5 },
        { x: 4, y: 5 },
        { x: 5, y: 5 },
        { x: 6, y: 5 },
        { x: 7, y: 5 },
        { x: 3, y: 6 },
        { x: 4, y: 6 },
        { x: 5, y: 6 },
        { x: 6, y: 6 },
        { x: 7, y: 6 }
    ]
}
