{
    tileset: "frosthaven",
    mapRef: "12b",
    offset: {
        x: 3,
        y: -20
    },
    cells: [
        { x: 2, y: 0 },
        { x: 3, y: 0 },
        { x: 4, y: 0 },
        { x: 5, y: 0 },
        { x: 2, y: 1 },
        { x: 3, y: 1 },
        { x: 4, y: 1 },
        { x: 5, y: 1 },
        { x: 6, y: 1 },
        { x: 1, y: 2 },
        { x: 2, y: 2 },
        { x: 3, y: 2 },
        { x: 4, y: 2 },
        { x: 5, y: 2 },
        { x: 6, y: 2 },
        { x: 1, y: 3 },
        { x: 2, y: 3 },
        { x: 3, y: 3 },
        { x: 5, y: 3 },
        { x: 6, y: 3 },
        { x: 7, y: 3 },
        { x: 0, y: 4 },
        { x: 1, y: 4 },
        { x: 2, y: 4 },
        { x: 5, y: 4 },
        { x: 6, y: 4 },
        { x: 7, y: 4 },
        { x: 1, y: 5 },
        { x: 2, y: 5 },
        { x: 6, y: 5 },
        { x: 7, y: 5 }
    ]
}
