{
    tileset: "frosthaven",
    mapRef: "13f",
    offset: {
        x: -1,
        y: 35
    },
    cells: [
        { x: 0, y: 1 },
        { x: 1, y: 1 },
        { x: 2, y: 1 },
        { x: 3, y: 1 },
        { x: 4, y: 1 },
        { x: 0, y: 2 },
        { x: 1, y: 2 },
        { x: 2, y: 2 },
        { x: 3, y: 2 },
        { x: 0, y: 3 },
        { x: 1, y: 3 },
        { x: 2, y: 3 },
        { x: 3, y: 3 },
        { x: 4, y: 3 },
        { x: 0, y: 4 },
        { x: 1, y: 4 },
        { x: 2, y: 4 },
        { x: 3, y: 4 },
        { x: 0, y: 5 },
        { x: 1, y: 5 },
        { x: 2, y: 5 },
        { x: 3, y: 5 },
        { x: 4, y: 5 },
        { x: 0, y: 6 },
        { x: 1, y: 6 },
        { x: 2, y: 6 },
        { x: 3, y: 6 },
        { x: 0, y: 7 },
        { x: 1, y: 7 },
        { x: 2, y: 7 },
        { x: 3, y: 7 },
        { x: 4, y: 7 }
    ]
}
